WWWWWWWWWWWW
WFFFFFFFFFFW
WFFFFFFFFFFW
WFFFFFFFFFFW
WFFFFFFFFFFW
WFFFWWWWFPFW
WFFFWWWWFFFW
WFFFWWWWFFFW
WFFPFFFFFFFW
WFFFFFFPFFFW
WFFFFFFFFPFW
WWWWWWWWWWWW